12 11 10 0 0 0 0 10 11 12 
0 12 11 10 0 0 10 11 12 0
0 0 12 11 10 10 11 12 0 0
0 0 0 12 11 11 12 0 0 0
0 0 0 0 12 12 0 0 0 0  
0 0 0 0 12 12 0 0 0 0
0 0 0 12 11 11 12 0 0 0
0 0 12 11 10 10 11 12 0 0
0 12 11 10 0 0 10 11 12 0
12 11 10 0 0 0 0 10 11 12 
0 0 0 0 0 0 0 0 0 0
0 0 0 0 0 0 0 0 0 0