11 11 11 11 11 11 11 11 11 11
12 12 12 12 12 12 12 12 12 12
13 13 13 13 13 13 13 13 13 13
0  0  0  0  0  0  0  0  0  0
0  0  0  0  0  0  0  0  0  0
0  0  0  0  0  0  0  0  0  0
0  0  0  0  0  0  0  0  0  0
0  0  0  0  0  0  0  0  0  0
