18 17 16 0 0 0 0 16 17 18 
0 18 17 16 0 0 16 17 18 0
0 0 18 17 16 16 17 18 0 0
0 0 0 18 17 17 18 0 0 0
0 0 0 0 18 18 0 0 0 0 
0 0 0 0 18 18 0 0 0 0
0 0 0 18 17 17 18 0 0 0
0 0 18 17 16 16 17 18 0 0
0 18 17 16 0 0 16 17 18 0
18 17 16 0 0 0 0 16 17 18 
0 0 0 0 0 0 0 0 0 0
0 0 0 0 0 0 0 0 0 0