0  0  0  0  0  0  0  0  0  0
0  10 10 10 10 10 10 10 10 0
10 11 11 11 11 11 11 11 11 10
12 11 11 11 11 11 11 11 11 12  
0  12 12 12 12 12 12 12 12 0
0  0  0  0  0  0  0  0  0  0
0  10 10 0  0  0  0  10 10 0
10 11 11 10 10 10 10 11 11 10
12 12 12 11 11 11 11 12 12 12  
0  0  0  0  0  0  0  0  0  0
0  0  0  0  0  0  0  0  0  0
0  0  0  0  0  0  0  0  0  0
