19 20 21 21 0 0 21 21 20 19 
19 20 21 0 0 0 0 21 20 19
19 20 21 0 0 0 0 21 20 19
19 20 21 0 0 0 0 21 20 19
19 20 21 0 0 0 0 21 20 19  
19 20 21 0 0 0 0 21 20 19
19 20 21 0 0 0 0 21 20 19
19 20 21 0 0 0 0 21 20 19
19 20 21 0 0 0 0 21 20 19
19 20 21 21 0 0 21 21 20 19
0 0 0 0 0 0 0 0 0 0
0 0 0 0 0 0 0 0 0 0