1 0 0 0 0 0 0 0 0 0
1 2 0 0 0 0 0 0 0 0
1 2 3 0 0 0 0 0 0 0
1 2 3 4 0 0 0 0 0 0
1 2 3 4 5 0 0 0 0 0
1 2 3 4 5 7 0 0 0 0
1 2 3 4 5 7 8 0 0 0
1 2 3 4 5 7 8 9 0 0
1 2 3 4 5 7 8 9 2 0
1 2 3 4 5 7 8 9 2 1
6 6 6 6 6 6 6 6 6 6
