31 31 31 31 31 31 31 31 31 31
32 32 32 32 32 32 32 32 32 32
33 33 33 33 33 33 33 33 33 33
0 0 0 0 0 0 0 0 0 0
0 0 0 0 0 0 0 0 0 0
0 0 0 0 0 0 0 0 0 0
0 0 0 0 0 0 0 0 0 0
0 0 0 0 0 0 0 0 0 0
