21 21 21 21 21 21 21 21 21 21 
19 0 0 0 20 20 0 0 0 19
19 0 20 0 21 21 0 20 0 19
19 0 0 0 20 20 0 0 0 19
20 0 0 0 0 0 0 0 0 20
20 0 0 0 0 0 0 0 0 20
19 0 0 0 20 20 0 0 0 19
19 0 20 0 21 21 0 20 0 19 
19 0 0 0 20 20 0 0 0 19
21 21 21 21 21 21 21 21 21 21 
0 0 0 0 0 0 0 0 0 0
0 0 0 0 0 0 0 0 0 0