41 41 41 41 41 41 41 41 41 41
42 42 42 42 42 42 42 42 42 42
43 43 43 43 43 43 43 43 43 43
0  0  0  0  0  0  0  0  0  0
0  0  0  0  0  0  0  0  0  0
0  0  0  0  0  0  0  0  0  0
0  0  0  0  0  0  0  0  0  0
0  0  0  0  0  0  0  0  0  0

