21 21 21 21 21 21 21 21 21 21
22 22 22 22 22 22 22 22 22 22
23 23 23 23 23 23 23 23 23 23
0  0  0  0  0  0  0  0  0  0
0  0  0  0  0  0  0  0  0  0
0  0  0  0  0  0  0  0  0  0
0  0  0  0  0  0  0  0  0  0
0  0  0  0  0  0  0  0  0  0
