51 51 51 51 51 51 51 51 51 51
52 52 52 52 52 52 52 52 52 52
53 53 53 53 53 53 53 53 53 53
0  0  0  0  0  0  0  0  0  0
0  0  0  0  0  0  0  0  0  0
0  0  0  0  0  0  0  0  0  0
0  0  0  0  0  0  0  0  0  0
0  0  0  0  0  0  0  0  0  0

