15 15 15 15 15 15 15 15 15 15 
14 14 14 0 0 0 0 14 14 14
13 13 0 13 13 13 13 0 13 13
13 13 0 14 15 15 14 0 13 13
14 14 0 14 15 15 14 0 14 14  
15 15 0 14 15 15 14 0 15 15
15 15 0 14 15 15 14 0 15 15
14 14 0 13 13 13 13 0 14 14
13 13 13 0 0 0 0 13 13 13
0 0 0 0 0 0 0 0 0 0
0 0 0 0 0 0 0 0 0 0
0 0 0 0 0 0 0 0 0 0