18 18 18 18 18 18 18 18 18 18 
17 16 16 16 0 0 16 16 16 17
17 16 16 16 0 0 16 16 16 17
18 17 16 0 0 0 0 16 17 18
18 17 16 0 0 0 0 16 17 18
18 17 16 0 0 0 0 16 17 18  
18 17 16 0 0 0 0 16 17 18
17 16 16 16 0 0 16 16 16 17
17 16 16 16 0 0 16 16 16 17
18 18 18 18 18 18 18 18 18 18 
0 0 0 0 0 0 0 0 0 0
0 0 0 0 0 0 0 0 0 0