0 0 0 0 21 21 0 0 0 0  
0 0 0 20 21 21 20 0 0 0
0 0 19 20 20 20 20 19 0 0
0 19 20 20 20 20 20 20 19 0
19 20 20 20 20 20 20 20 20 19
0 0 0 0 0 0 0 0 0 0
0 0 0 0 0 0 0 0 0 0
0 0 0 0 0 0 0 0 0 0
0 0 0 0 0 0 0 0 0 0
0 0 0 0 0 0 0 0 0 0
0 0 0 0 0 0 0 0 0 0
0 0 0 0 0 0 0 0 0 0