12 0 0 0 0 0 0 0 0 12 
12 10 10 11 11 11 11 10 10 12  
12 10 10 11 11 11 11 10 10 12
12 10 10 11 11 11 11 10 10 12
12 0 0 0 0 0 0 0 0 12
12 0 0 0 0 0 0 0 0 12
0 10 10 10 10 10 10 10 10 0  
0 0 11 11 11 11 11 11 0 0
0 0 0 12 12 12 12 0 0 0  
0 0 0 0 0 0 0 0 0 0
0 0 0 0 0 0 0 0 0 0
0 0 0 0 0 0 0 0 0 0